
  ┌───────────────────────────────────────────────┐
  │ ┌────────────────────┐ ┌────────────────────┐ │
  │ │       Global       │ │      Personal      │ │
  │ ├────────────────────┤ ├────────────────────┤ │
  │ │                    │ │                    │ │
  │ │                    │ │                    │ │
  │ │                    │ │                    │ │
  │ │                    │ │                    │ │
  │ │                    │ │                    │ │
  │ │                    │ │                    │ │
  │ │                    │ │                    │ │
  │ │                    │ │                    │ │
  │ │                    │ │                    │ │
  │ │                    │ │                    │ │
  │ │                    │ │                    │ │
  │ │                    │ │                    │ │
  │ └────────────────────┘ └────────────────────┘ │
  │ ┌─────────┐                       ┌─────────┐ │
  │ │ Cancel  │                       │  Save   │ │
  │ └─────────┘                       └─────────┘ │
  └───────────────────────────────────────────────┘